0 G
WWWWWSWWWW
     S    
 WWWWWWSWW
       S  
SWWWWWWWWW
S    m    
WWWWWWWWSW
t H     S 
WWWWWWWWWW